항공데이터, 티켓값

항공데이터 --> 운행편대(수), 공항사별 편대, 요일별 편대, 시간대별 통계, 국제선or국내선 통계

공항별 통계---
대부분 인천공항에 집중되어 있음(사실)

총 운행편대
총 운행여객 수
총 운행화물 톤

운행기-> 화물, 여객

화물선의 경우 김해, 제주, 인천 만 존재-> 의미있는 데이터 X

 우리나라 대부분이 인천공항을 이용하고 있다  --->진짜인가?


항공편 대비 여객인원의 비율을 통해 항공기당 여객이용률 산출

인구수 대비 항공편대수 또는 여객이용 수를 통해 인구수 대비 수용률 산출




여객선의 기준으로 공항별 통계--> 
김포 ->경기도 김포시
	김해 -> 경산남도 김해시
	사천-> 경상남도 사천시
제주-> 제주도
대구-> 대구
광주-> 광주
	무안-> 전라남도 무안군
	여수-> 전라남도 여수시
청주-> 충북 청주
	양양-> 강원도 양양군
	원주-> 강원도 원주시
울산-> 울산
포항경주->경상북도 포항
군산-> 전라북도 군산시
인천-> 인천

2021 -> 인천공항 롯데, 신라 면세점 철수(코로나)
2022 -> 오미크론 in 인천